14
15
1 10 0 9 0 0 0 0 0 0 0 0 0 0 0
1 5 1 1 0 0 0 0 0 0 0 0 0 0 0
1 5 1 0 0 0 0 0 0 0 0 0 0 0 0
1 5 1 0 0 0 0 0 0 0 0 0 0 0 0
1 10 1 0 0 0 0 0 0 0 0 0 0 0 0
1 5 1 0 0 0 0 0 0 0 0 0 0 0 0
1 5 1 0 0 0 0 0 0 0 0 0 0 0 0
1 5 1 0 0 0 0 0 0 0 0 0 0 0 0
1 10 1 0 0 0 0 0 0 0 0 0 0 0 0
1 5 1 0 0 0 0 0 0 0 0 0 0 0 0
1 5 1 0 0 0 0 0 0 0 0 0 0 0 0
1 10 0 0 0 0 0 0 0 0 0 0 0 8 0
1 1 0 0 0 0 1 1 0 0 0 0 1 1 1
0 1 1 0 0 0 0 1 0 0 0 0 0 0 0