14
15
0 0 0 0 0 0 0 0 0 0 0 0 0 0 0
0 9 0 0 0 0 0 0 0 0 0 0 0 0 0
1 1 1 1 2 1 0 0 0 0 0 0 0 0 0
0 0 0 0 0 0 1 1 2 6 6 1 1 0 1
0 0 0 0 0 0 0 0 0 0 0 0 0 5 1
0 0 0 0 0 0 0 0 0 0 0 0 0 5 1
1 1 0 1 0 0 0 0 0 0 0 0 0 5 1
1 0 0 1 0 0 0 0 1 2 2 2 1 0 0
1 0 0 1 0 0 0 0 0 0 0 0 0 0 0
1 0 1 1 0 0 0 0 7 0 0 0 0 0 0
1 0 0 1 0 0 0 0 0 0 0 0 0 0 0
1 0 0 1 0 0 0 0 0 0 0 0 0 0 0
1 0 0 0 0 0 0 0 0 0 0 0 0 8 0
1 1 1 1 1 1 1 2 6 6 1 1 1 1 1