14
15
0 0 0 0 0 1 1 1 1 1 1 0 0 0 0
0 0 0 0 0 0 0 1 0 0 0 0 1 0 0
0 0 0 1 0 0 0 1 0 0 0 1 0 0 0
0 0 1 0 6 6 6 1 0 0 1 0 0 0 0
1 0 0 0 1 1 1 1 1 1 4 0 0 0 0
0 1 0 0 1 0 0 1 0 0 1 0 0 0 0
0 0 0 0 1 5 3 1 3 0 0 1 0 0 0
0 0 0 0 1 1 1 1 1 0 0 1 0 0 1
0 0 1 0 0 0 0 1 0 0 1 0 1 0 0
0 0 0 0 0 4 0 1 1 0 0 0 1 3 1
0 0 0 0 0 1 1 1 0 0 1 0 0 1 0
0 0 0 0 0 0 0 1 1 0 0 0 0 0 0
0 0 0 9 0 1 0 0 4 0 0 8 0 0 3
1 1 1 1 1 1 1 1 1 1 1 1 1 1 1