14
15
0 0 0 0 8 0 0 5 0 6 0 0 0 0 0
4 0 0 1 1 1 1 1 0 1 0 0 1 1 1
1 1 0 0 0 0 3 0 0 3 0 4 0 0 0
6 6 4 0 0 0 1 0 1 1 1 1 0 0 0
1 1 1 1 2 0 0 0 0 0 1 0 6 6 6
0 0 9 1 0 0 5 0 7 0 1 0 0 4 0
1 1 1 1 1 0 1 0 1 1 1 1 1 1 1
0 0 0 0 3 0 0 0 0 0 0 1 0 0 1
7 0 0 0 2 6 6 6 0 7 0 1 0 0 1
1 0 0 0 0 0 0 4 0 1 1 1 1 1 1
0 1 0 1 1 1 1 1 1 1 0 1 0 0 0
0 0 0 0 0 1 0 0 0 1 0 1 0 0 0
0 0 1 0 0 0 0 3 0 1 0 1 0 0 0
6 6 1 1 1 1 1 1 1 1 0 1 0 0 0