14
15
0 8 0 0 0 0 0 0 0 0 0 0 0 0 0
1 1 1 0 4 0 0 0 0 0 0 0 0 0 0
0 0 1 1 1 1 0 0 0 0 0 0 0 4 0
9 4 1 0 0 0 4 0 0 4 1 1 1 1 1
1 1 1 0 4 1 1 1 1 1 0 0 0 0 0
0 0 1 1 1 0 0 1 0 0 0 0 0 0 0
0 7 1 0 0 0 0 1 0 7 0 0 0 0 0
1 1 1 7 0 1 3 6 6 1 1 0 0 4 0
0 0 0 1 1 0 0 0 0 1 0 0 0 1 0
7 0 3 1 3 0 1 0 0 0 0 0 1 0 0
1 1 1 1 1 1 0 0 0 1 1 0 0 0 0
0 0 0 0 1 0 0 0 0 0 0 0 0 0 0
0 7 0 4 1 3 0 6 6 6 6 6 6 6 6
1 1 1 1 1 1 1 1 1 1 1 1 1 1 1